┌─────────────────────────────────────────────────────────────────────┐
│ Professor Dashboard • Dr. Chen - MATH202                          👤│
├─────────────────────────────────────────────────────────────────────┤
│ ┌─────────────┐ ┌─────────────┐ ┌─────────────┐ ┌─────────────┐     │
│ │   ACTIVE    │ │ ATTENDANCE  │ │  GRADING    │ │  ANALYTICS  │     │
│ │  SESSIONS   │ │  85% Today  │ │ 12 Pending  │ │ Engagement  │     │
│ │ Start New → │ │ View Report │ │ Grade Now → │ │ View Stats →│     │
│ └─────────────┘ └─────────────┘ └─────────────┘ └─────────────┘     │
│                                                                     │
│ ┌─────────────────────────────────────────────────────────────────┐ │
│ │                    CURRENT COURSES                              │ │
│ ├─────────────────────────────────────────────────────────────────┤ │
│ │ MATH202 - Advanced Calculus • 45 students • Mon/Wed 10 AM       │ │
│ │ ┌─────┐ ┌─────┐ ┌─────┐ ┌─────┐ ┌─────┐                         │ │
│ │  Chat  Record  Materials  Assignments  Analytics         │ │
│ │                                                                 │ │
│ │ CS301 - Data Structures • 32 students • Tue/Thu 2 PM           │ │
│ │ ┌─────┐ ┌─────┐ ┌─────┐ ┌─────┐ ┌─────┐                         │ │
│ │  Chat  Record  Materials  Assignments  Analytics         │ │
│ └─────────────────────────────────────────────────────────────────┘ │
└─────────────────────────────────────────────────────────────────────┘